#################################E###
###....#.....#......###...#...#...#.#
#.G.##...###.#.####.#...#..##.#.##..#
#.#########..#......#P##...##.#.#..##
#...........P.##.##.###..#...W..#...#
######.#######........G#.##########.#
#S........G.....#.#P##..............#
#####################################