###################################
###....#.....#......###...#...#...#
#.G.##...###...####.....#..##.#.###
#.#########.###.....#P#.#####.#.#.#
#.............##.##.###..#......#.#
#####.#####.#.........G#.##.#######
#.........G.###.#.#P##............#
####.....#.......#E...##.....#....#
######.#########..########...######
######.....#......#####.......#####
##.##.##.###.##.##.##.###.###.##..#
#.##.###.##..#.....S####.###.##..#